               ------              
               |....|    ----------
               |.<..|####...@.....|
               |....-#   |........|
               |....|    |........|
               ------    ----------