                       ####################
                       #........#.........#
                       #........#.........#
                       #........+....0....#
                       #........#.........#
                       #........#.........#
                       #........#.........#
                       ####################