|-------|    |-------|
|.......|    |...#...|
|.......|    |.......|
|.......|    |.......|
|---+---|    |---+---|
|.......|    |.......|
|......-|----|.......|
|....-|......|.......|
|.....+	.............|
|....-|..............|
|--|..............|--|
   |..............|
   |--------------|   
