##################
#.....+...##.....#   
#+###.#...##.###.#  
#.###.#...+..###.#
#...#.#+####+#  ###
#...#...####.####.#
#...#####.....###.#
#...#    #.....##.#
#...#    #........#
###+###############
  #.#.....#
  #.#..0..#
  #.#.....#
  #.......#
  #########