#########    #########
#.......#    #...0...#
#.......#    #.......#
#.......#    #.......#
####+####    ####+####
#.......#    #.......#
#......#######.......#
#....##......#.......#
#.....+	.............#
#....##..............#
####..............####
   #..............#
   ################   
