####################
#..................#
 #................#
  #.#####+########
   #.#.......#..#
  #..#.......#...#
 #....#.....#.....#
#....###+###.......#	
#.................#
  #.....###########
   #...#
  #..0...#
  #.......#
  #########