                       --------------------
                       |........|.........|
                       |........|.........|
                       |........+....#....|
                       |........|.........|
                       |........|.........|
                       |........|.........|
                       --------------------