|----------------------------|
|.+............+.............|
|............................|
|............................|
|............................|
|....+.......................|
|............................|
|...........+................|
|...........................+|
|----------------------------|
